107
8
39 21 0 0 0 0 0 0 0 0 0 0 0 0 0 0 0 0 0 0 0 0 0 0 0 0 0 0 0 0 0 0 0 0 0 0 0 0 0 0 0 0 0 20 39 39 39 39 39 39 39 39 39 39 39 39 39 39 39 39 39 39 39 39 39 39 39 39 39 39 39 39 39 39 39 21 0 0 0 0 0 0 0 0 0 0 0 0 0 0 20 39 39 39 39 39 39 39 39 39 39 39 39 39 39 39 39 
39 21 0 0 0 0 0 0 0 0 0 0 0 0 0 0 0 0 0 0 0 0 0 0 0 0 0 0 0 0 0 0 0 0 0 0 0 0 0 0 0 0 0 0 23 39 39 39 39 39 39 39 39 39 39 39 39 39 39 39 24 22 22 22 22 22 22 22 22 22 23 39 39 39 39 21 0 0 0 0 0 0 0 0 0 0 0 0 0 0 0 23 39 39 39 39 39 24 22 22 22 22 22 22 22 23 39 
39 21 0 0 0 0 0 0 0 0 0 0 13 0 0 0 0 0 14 15 0 0 0 0 0 0 0 0 0 0 0 0 0 0 0 0 0 0 0 0 10 0 0 0 0 22 22 22 23 39 39 39 39 39 39 39 39 39 39 39 21 0 0 16 0 0 0 0 0 0 0 22 23 39 39 21 0 0 0 0 0 0 0 0 0 0 0 0 0 0 0 0 23 39 39 39 39 21 0 0 0 0 0 0 0 20 39 
39 21 0 0 0 0 0 0 0 0 0 0 0 0 0 11 0 0 0 0 0 0 0 0 0 0 0 0 0 0 0 0 0 0 11 0 0 0 0 36 37 38 0 0 0 0 0 0 0 22 22 23 39 39 39 39 39 39 39 24 0 0 10 0 11 0 0 0 0 0 0 0 0 22 22 0 0 0 0 9 0 0 0 0 25 35 26 0 0 0 0 0 0 23 39 39 39 21 0 0 0 0 0 0 0 20 39 
39 21 0 0 0 12 0 0 0 0 0 0 11 25 35 35 26 0 0 0 0 0 0 0 0 0 0 16 0 0 0 0 0 36 38 0 0 0 0 0 0 0 0 0 0 9 11 0 0 0 0 0 22 22 22 22 22 22 22 0 0 25 35 35 35 26 0 0 0 0 0 0 0 0 0 0 0 0 0 36 37 38 0 0 20 39 21 0 0 0 0 0 0 0 23 39 39 21 0 0 0 0 0 0 0 20 39 
39 21 0 0 0 0 0 0 0 0 25 35 35 35 6 39 21 0 0 0 0 0 10 9 0 0 0 0 0 0 10 0 0 0 0 0 0 11 0 0 0 0 0 25 35 35 35 35 26 0 0 0 9 0 0 0 0 9 0 0 0 20 39 39 39 21 0 0 0 0 0 0 0 0 0 0 0 0 0 0 0 0 0 0 20 39 21 0 0 0 0 0 0 0 0 22 33 0 0 0 0 0 0 0 0 20 39 
39 21 9 27 10 0 0 0 0 11 20 39 39 39 39 39 21 0 0 0 25 35 35 35 35 26 0 0 9 25 35 35 26 0 9 25 35 35 26 0 0 0 0 20 39 39 39 39 21 10 0 25 35 26 0 0 25 35 26 11 25 35 6 39 39 21 0 0 0 0 0 0 0 9 0 0 10 9 0 0 11 0 0 25 35 5 35 26 0 0 0 0 0 0 0 0 34 0 0 10 11 0 0 9 0 20 39 
5 35 35 35 35 35 35 35 35 35 35 6 39 39 39 39 21 0 0 0 20 39 39 39 39 35 35 35 35 35 6 5 35 35 35 35 6 39 21 0 0 0 0 20 39 39 39 5 35 35 35 35 35 35 35 35 35 35 35 35 35 6 39 39 39 21 0 0 0 0 0 25 35 35 35 35 35 35 35 35 35 35 35 35 6 39 5 35 35 35 35 35 35 35 35 35 35 35 35 35 35 35 35 35 35 35 6 