107
8
28 4 0 0 0 0 0 0 0 0 0 0 0 0 0 0 0 0 0 0 0 0 0 0 0 0 0 0 0 0 0 0 0 0 0 0 0 0 0 0 0 0 0 3 29 29 29 28 28 28 29 28 28 29 29 29 29 28 28 29 29 28 28 28 29 29 29 29 28 28 29 29 29 28 28 4 0 0 0 0 0 0 0 0 0 0 0 0 0 0 3 29 29 29 29 29 29 28 28 28 29 29 29 29 28 28 28 
28 4 0 0 0 0 0 0 0 0 0 0 0 0 0 0 0 0 0 0 0 0 0 0 0 0 0 0 0 0 0 0 0 0 0 0 0 0 0 0 0 0 0 0 18 28 28 29 29 29 29 29 29 28 28 28 28 28 29 29 19 17 17 17 17 17 17 17 17 17 18 28 28 28 29 4 0 0 0 0 0 0 0 0 0 0 0 0 0 0 0 18 29 29 29 29 28 19 17 17 17 17 17 17 17 18 28 
28 4 0 0 0 0 0 0 0 0 0 0 13 0 0 0 0 0 14 15 0 0 0 0 0 0 0 0 0 0 0 0 0 0 0 0 0 0 0 0 0 0 0 0 0 17 17 17 18 28 28 29 29 29 29 29 28 28 28 28 4 0 0 16 0 0 0 0 0 0 0 17 18 28 29 4 0 0 0 0 0 0 0 0 0 0 0 0 0 0 0 0 18 29 29 29 29 4 0 0 0 0 0 0 0 3 29 
28 4 0 0 0 0 0 0 0 0 0 0 0 0 0 0 0 0 0 0 0 0 0 0 0 0 0 0 0 0 0 0 0 0 0 0 0 0 0 30 31 32 0 0 0 0 0 0 0 17 17 18 28 28 28 29 29 29 29 19 0 0 0 0 0 0 0 0 0 0 0 0 0 17 17 0 0 0 0 0 0 0 0 0 3 29 4 0 0 0 0 0 0 18 28 28 28 4 0 0 0 0 0 0 0 3 28 
28 4 0 0 0 12 0 0 0 0 0 0 0 3 28 28 4 0 0 0 0 0 0 0 0 0 0 16 0 0 0 0 0 30 32 0 0 0 0 0 0 0 0 0 0 0 0 0 0 0 0 0 17 17 17 17 17 17 17 0 0 3 28 28 29 4 0 0 0 0 0 0 0 0 0 0 0 0 0 30 31 32 0 0 3 29 4 0 0 0 0 0 0 0 18 29 29 4 0 0 0 0 0 0 0 3 28 
28 4 0 0 0 0 0 0 0 0 3 29 29 29 28 28 4 0 0 0 0 0 0 0 0 0 0 0 0 0 0 0 0 0 0 0 0 0 0 0 0 0 0 3 28 28 28 28 4 0 0 0 0 0 0 0 0 0 0 0 0 3 29 29 29 4 0 0 0 0 0 0 0 0 0 0 0 0 0 0 0 0 0 0 3 29 4 0 0 0 0 0 0 0 0 17 33 0 0 0 0 0 0 0 0 3 28 
28 4 0 0 0 0 0 0 0 0 3 28 28 29 29 29 4 0 0 0 3 28 29 29 29 4 0 0 0 3 29 28 4 0 0 3 28 28 4 0 0 0 0 3 28 29 29 29 4 0 0 3 29 4 0 0 3 29 4 0 3 29 28 29 29 4 0 0 0 0 0 0 0 0 0 0 0 0 0 0 0 0 0 3 29 29 29 4 0 0 0 0 0 0 0 0 34 0 0 0 0 0 0 0 0 3 28 
29 29 29 29 29 29 29 28 28 28 29 28 28 28 29 29 4 0 0 0 3 29 29 28 28 29 28 28 28 28 28 29 28 28 29 29 28 28 4 0 0 0 0 3 28 29 29 29 29 28 28 28 28 29 29 29 29 29 29 29 28 28 29 28 28 4 0 0 0 0 0 3 28 28 28 29 29 29 28 28 28 28 29 29 28 28 29 29 29 29 29 28 28 28 28 28 29 29 29 29 29 29 29 29 29 29 28 
