107
8
22 4 0 0 0 0 0 0 0 0 0 0 0 0 0 0 0 0 0 0 0 0 0 0 0 0 0 0 0 0 0 0 0 0 0 0 0 0 0 0 0 0 0 3 22 22 22 22 22 22 22 22 22 22 22 22 22 22 22 22 22 22 22 22 22 22 22 22 22 22 22 22 22 22 22 4 0 0 0 0 0 0 0 0 0 0 0 0 0 0 3 22 22 22 22 22 22 22 22 22 22 22 22 22 22 22 22 
22 4 0 0 0 0 0 0 0 0 0 0 0 0 0 0 0 0 0 0 0 0 0 0 0 0 0 0 0 0 0 0 0 0 0 0 0 0 0 0 0 0 0 0 18 22 22 22 22 22 22 22 22 22 22 22 22 22 22 22 19 17 17 17 17 17 17 17 17 17 18 22 22 22 22 4 0 0 0 0 0 0 0 0 0 0 0 0 0 0 0 18 22 22 22 22 22 19 17 17 17 17 17 17 17 18 22 
22 4 0 0 0 0 0 0 0 0 0 0 13 0 0 0 0 0 14 15 0 0 0 0 0 0 0 0 0 0 0 0 0 0 0 0 0 0 0 0 10 0 0 0 0 17 17 17 18 22 22 22 22 22 22 22 22 22 22 22 4 0 0 16 0 0 0 0 0 0 0 17 18 22 22 4 0 0 0 0 0 0 0 0 0 0 0 0 0 0 0 0 18 22 22 22 22 4 0 0 0 0 0 0 0 3 22 
22 4 0 0 0 0 0 0 0 0 0 0 0 0 0 11 0 0 0 0 0 0 0 0 0 0 0 0 0 0 0 0 0 0 11 0 0 0 0 29 30 31 0 0 0 0 0 0 0 17 17 18 22 22 22 22 22 22 22 19 0 0 10 0 11 0 0 0 0 0 0 0 0 17 17 0 0 0 0 9 0 0 0 0 1 28 2 0 0 0 0 0 0 18 22 22 22 4 0 0 0 0 0 0 0 3 22 
22 4 0 0 0 12 0 0 0 0 0 0 11 1 28 28 2 0 0 0 0 0 0 0 0 0 0 16 0 0 0 0 0 29 31 0 0 0 0 0 0 0 0 0 0 9 11 0 0 0 0 0 17 17 17 17 17 17 17 0 0 1 28 28 28 2 0 0 0 0 0 0 0 0 0 0 0 0 0 29 30 31 0 0 3 22 4 0 0 0 0 0 0 0 18 22 22 4 0 0 0 0 0 0 0 3 22 
22 4 0 0 0 0 0 0 0 0 1 28 28 28 6 22 4 0 0 0 0 0 10 9 0 0 0 0 0 0 10 0 0 0 0 0 0 11 0 0 0 0 0 1 28 28 28 28 2 0 0 0 9 0 0 0 0 9 0 0 0 3 22 22 22 4 0 0 0 0 0 0 0 0 0 0 0 0 0 0 0 0 0 0 3 22 4 0 0 0 0 0 0 0 0 17 26 0 0 0 0 0 0 0 0 3 22 
22 4 9 0 10 0 0 0 0 11 3 22 22 22 22 22 4 0 0 0 1 28 28 28 28 2 0 0 9 1 28 28 2 0 9 1 28 28 2 0 0 0 0 3 22 22 22 22 4 10 0 1 28 2 0 0 1 28 2 11 1 28 6 22 22 4 0 0 0 0 0 0 0 9 0 0 10 9 0 0 11 0 0 1 28 5 28 2 0 0 0 0 0 0 0 0 27 0 0 10 11 0 0 9 0 3 22 
5 28 28 28 28 28 28 28 28 28 28 6 22 22 22 22 4 0 0 0 3 22 22 22 22 28 28 28 28 28 6 5 28 28 28 28 6 22 4 0 0 0 0 3 22 22 22 5 28 28 28 28 28 28 28 28 28 28 28 28 28 6 22 22 22 4 0 0 0 0 0 1 28 28 28 28 28 28 28 28 28 28 28 28 6 22 5 28 28 28 28 28 28 28 28 28 28 28 28 28 28 28 28 28 28 28 6 
